1111111111111111111111111111111111111111
1E0000000000000C000001000000000000000001
1011110100100000111001000000010000000001
1110011110111010001001000100011111000001
100000000C01C0000000010001C00000C1000001
100000000001000C000001000110000001100001
1110011100110000111001000010010111000001
1110010111101010001111000010011100000001
10000000000000000000000001100000C0000001
100000000000000C00000C000100000000000001
1110010100100000000111110010011110000001
1110010011101010001001110010010111000001
10000000000000000000000100100001C0000001
100000000000000C00000C110010000100000001
1011110111100000111001110000011100000001
1010010010111111111001110010011100000001
1P1000000C00C0000000000000100000C0000001
1111111111111111111111111111111111111111