11111111111111111111111111
1P00000100000000000000C1C1
10111010101110111111000101
10000010000100010001100001
10111110111011111011101111
1000000C00001001C000000011
11101110111010011011101001
1C0000100000C001100000C001
10111011101110111110111011
100010000000001111000000E1
11111111111111111111111111