11111111111111111111111111111111111111
1E0000000000000C0000010000000000000001
10111101001000001110010000000100000001
11100111101110100010010001000111110001
100000000C01C0000000010001C00000C10001
100000000001000C0000010001100000011001
11100111001100001110010000100101110001
11100101111010100011110000100111000001
10000000000000000000000001100000C00001
100000000000000C00000C0001000000000001
11100101001000000001111100100111100001
11100100111010100010011100100101110001
10000000000000000000000100100001C00001
100000000000000C00000C1100100001000001
10111101111000001110011100000111000001
10100100101111111110011100100111000001
1P1000000C00C0000000000000100000C00001
11111111111111111111111111111111111111